6 24
////////////////////////
/---------------------2/
/-//-///////////////////
/--------------1-----10/
/----------------------/
////////////////////////